1,1,1,1,1,1,1,1,1,1,1,1,1,1,1,1,1,1,1,1,1,1,1,1,1,1,1,
1,0,0,0,0,0,4,0,0,0,0,0,0,0,0,4,0,0,0,0,0,4,0,0,0,0,1,
1,0,0,0,0,0,4,0,0,0,0,0,0,0,0,4,0,0,0,0,0,4,0,0,0,0,1,
1,8,9,0,0,0,4,0,0,0,0,0,0,0,0,4,0,0,0,0,0,4,0,0,12,10,1,
1,1,1,1,1,1,1,1,1,1,5,1,2,1,1,1,1,1,0,1,2,1,1,1,1,1,1,
1,0,0,0,0,0,0,0,0,0,0,0,4,0,0,0,0,0,0,0,4,0,0,0,0,0,1,
1,0,0,0,0,0,0,0,0,0,0,0,4,0,0,0,0,0,0,0,4,0,0,0,0,0,1,
1,8,0,0,0,0,0,0,0,0,6,0,4,0,0,0,0,7,6,0,4,0,0,0,11,10,1
1,1,1,1,1,1,2,1,3,1,1,1,1,1,1,3,1,1,1,2,1,11,1,,1,1,1,
