1,1,1,1,1,1,1,1,1,1,1,1,1,1,1,1,1,1,1,1,1,1,1,1,1,1,1,
1,0,0,0,0,4,0,0,0,0,0,0,0,0,0,0,0,1,0,0,0,0,0,0,0,0,1,
1,0,0,0,0,4,0,0,0,0,0,0,0,0,0,0,0,1,0,0,0,0,0,0,0,0,1,
1,8,8,0,0,4,0,0,0,0,0,0,0,0,0,7,0,1,0,0,0,0,0,0,12,10,1.
1,1,1,1,2,1,2,1,0,1,1,2,1,5,1,1,1,1,0,2,1,1,0,2,1,1,1,
1,0,0,0,4,0,0,0,0,1,0,0,0,0,0,0,0,0,0,0,4,0,0,0,0,0,1,
1,0,0,0,4,0,0,0,0,1,0,0,0,0,0,0,0,0,0,0,4,0,0,0,0,0,1,
1,8,0,0,4,0,0,0,6,1,0,0,0,0,0,0,0,0,6,0,4,0,6,0,10,10,1,
1,1,1,1,1,2,1,1,1,1,1,1,1,1,1,2,1,1,1,1,1,2,1,1,1,1,1
